NO ./assets/textures/north_texture
SO ./assets/textures/south_texture
WE ./assets/textures/west_texture
EA ./assets/textures/east_texture

F 220,100,0
C 225,30,0

        1111111111111111111111111
        1000000000110000000000001
        10000000000N0000000000001
        1111111111111111111111111